
Account settings
Exit
More...
Mobile applications
Browser extensions
Answers to questions
Игорь Луганский0
 Offer+gift
The Jungle
Courses
Words and phrases
Exercises
Dictionary
Social
My vocabulary
My groups of words
My dictionary  View Train
All1078Add AllWordsPhrasesSentence
 December 2012: 36
obey  —  подчиняться
quote  —  ссылаться
ancient  —  древний
interior  —  внутренняя сторона
preceded  —  предшествующий
parentheses  —  скобки
claim  —  требовать
brush  —  щетка, легко касаться
comprehensions  —  генераторы, охват
pickled  —  маринованный
enclosing  —  включающий в себя
favor  —  расположение
occasionally  —  время от времени
misspelled  —  написанный с ошибками
outermost  —  самый дальний от середины, от центра
unless  —  до тех пор
cluttered  —  захламлять
collide  —  сталкиваться
suppress  —  подавлять
fairly  —  довольно
spurious  —  ложный
caught  —  пойманный
huge  —  огромный
benchmarks  —  Критерии эффективности
debouncing  —  устранение дребезга
snappy  —  живой, разг. модный
expired  —  истек
go off  —  уходить
worth  —  стоимость
intact  —  нетронутый
alien  —  несвойственный
scientist  —  учёный
put off  —  снимать (одежду), откладывать, отбрасывать
generic  —  обобщённый
scrambled  —  взбитый
tweak  —  настройка
 November 2012: 116
just  —  просто
ask for  —  просить чего-либо
what going on  —  что происходит
opinion  —  мнение
collaborate  —  сотрудничать
vulnerable  —  уязвимый
expose  —  обнажать
accomplish  —  выполнять
retrieval  —  поиск
coarse-grained  —  крупнозернистый
fine-grained  —  мелкозернистый
Impact  —  воздействие
interoperability  —  функциональная совместимость
instance  —  пример
impose  —  навязать
advertise  —  рекламировать
bulk  —  большая часть
span  —  промежуток времени
below  —  ниже
strict  —  строгий
eleminate  —  исключать.игнорировать
adjasent  —  смежный
outweigh  —  перевешивать
overall  —  общий
envolve  —  Развивать
meanwhile  —  тем временем
accommodate  —  приспосабливать
delineation  —  чертёж
blueprint  —  план
meaningful  —  осмысленно
confused  —  в замешательстве
irrespective  —  независимый
relevant  —  относящийся к делу
fit  —  соответствовать
distinct  —  определённый
considerations  —  соображения
valuable  —  ценный
tiny  —  крошечный
gross  —  отвратительный
care to  —  соглашаться, хотеть, желать
kid stuff  —  ерунда, детские игрушки
whim  —  каприз
feverish  —  возбужденный
cry  —  плакать
resort  —  курорт
ski  —  ходить на лыжах
swear to you  —  клянусь вам
not at all  —  ничуть, совсем нет (в ответах)
gonna be  —  будет
occupants  —  пассажиры
i was about to  —  Я собирался
exposure to  —  воздействие
suggest that  —  указывать на
not that  —  не то, чтобы, не настолько
feeling of  —  чувство
aimed at  —  направленный на, предназначенный для
statue  —  статуя
Busy guy  —  занятой человек.
bud  —  расцветать
freaks  —  в ярость
therapy  —  лечение
take it easy  —  не волнуйтесь, не бери в голову
pull out  —  вытаскивать, вынимать, выйти из дела, выдёргивать
turn around  —  оборачиваться
egghead  —  умник
reel in  —  заманить, привлечь, вовлечь
cloud  —  облако
promotion  —  повышение
accomplished  —  совершённый
closure  —  исцеление, окончание
wander off  —  блуждать, скитаться
toss-up  —  что-л. неопределённое
dumbest  —  тупой
stud  —  жеребец
strictly  —  строго
rekindle  —  вновь зажечь
borrow  —  брать на время
take a walk  —  погулять, прогуляться
heavy  —  тяжёлый
diseases  —  болезни
advance  —  развиваться
study  —  изучение
profile  —  профиль
might have triggered  —  возможно вызвало
solar  —  солнечный
cosmic borne  —  космические происхождения
exposure  —  подвергание
flew  —  летал
shotgun  —  переднее сидень в машине рядом с водителем
payroll  —  заработная плата
assure  —  уверять
picking up  —  поднимая, собирание
wind  —  ветер
space  —  космос
turn out  —  оказаться, получиться, выйти
pay off  —  окупиться, отплатить, отомстить
firstborn  —  первенец
savor  —  наслаждатся
bill  —  счет
cure  —  лекарство
conducted  —  проводятся
a study  —  исследование
triggered  —  запущен
born  —  рожденный
expose to  —  подвергать
suggest  —  предлагать
defense  —  защита
Defence  —  защита
take to get  —  предпринять, чтобы получить
top floor  —  верхний этаж
elevator  —  амер. лифт
executive  —  администратор
larger than life  —  больше натуральной величины
Mall  —  крупный торговый комплекс
ain't  —  разг. are not
aimed  —  предназначенный
conveniently  —  удобно
 October 2012: 218
inventory  —  инвентарь
sore  —  больной
lunch  —  обед
begets  —  порождает
dunno  —  don't know
armed  —  вооружённый
closer  —  ближе
squeeze  —  сжимать
fragile  —  хрупкий
ambush  —  засада
thrilled  —  взволнованный
helm  —  штурвал
gimme  —  дай сюда
hootchie  —  притон
kootchie  —  простофиля
lollies  —  леденцы
follies  —  глупости
flopped  —  плюхаться
temple  —  храм
popsicle  —  фруктовое мороженое
rigged  —  подстроенный
punch  —  удар кулаком
won  —  прош. вр. от win, победить, выиграть
weddings  —  свадьба
crate  —  ящик
merchant  —  торговец
screwed  —  напортачил
magnificent  —  великолепный
crates  —  контейнер
launcher  —  гранатомёт
ugly  —  уродливый
exactly  —  точно
limp  —  безвольный
heating  —  отопление
lap  —  колени
dinged  —  разбился
fender  —  каминная решётка
miracle  —  чудо
throughout  —  повсюду
bizarre  —  причудливый
fare  —  плата за проезд
bride  —  новобрачная невеста
fog  —  туман
shut up  —  заставить замолчать
chase  —  гнаться
emergency  —  аварийный
cooperating  —  взаимодействующий
Lucky  —  удачный
daffy  —  чокнутый
bastard  —  груб. ублюдок
dove  —  голубь
calm  —  спокойный
ladder  —  лестница
alert  —  бдительный
develop  —  развивать
unbreakable  —  небьющийся
bandages  —  повязки
tissue  —  ткань
polite  —  вежливый
tightly  —  тесно
freak  —  уродец
memo  —  заметка
survivor  —  оставшийся в живых
granted  —  предоставленный
possess  —  владеть
rot  —  гниль
cab  —  такси
slut  —  проститука
at least,  —  По крайней мере,
sweetie  —  детка
tryin'  —  надоедливый
towards  —  по направлению к
anticipating  —  ожидать
citizens  —  жители
fellow  —  товарищ
death  —  смерть
offer  —  предлагать
overshot  —  и p-p. от overshoot (промахнуться)
calibers  —  калибры
air  —  воздух
fulfil  —  выполнять
gathering  —  собрание
defenceless  —  уязвимый
priest  —  священник
discover  —  обнаруживать
unbelievable  —  невероятный
divine  —  божественный
prehistoric  —  доисторический
toast  —  тост
fame  —  слава
parched  —  пересохший
extraordinary  —  экстраординарный
suppose  —  предполагать
beloved  —  любимый
hop  —  прыгать
injured  —  раненый
grew  —  вырос
fell  —  упал
once  —  однажды
eclipse  —  затмевать
start  —  начинать
shells  —  ракушка
tower  —  башня
dropped  —  снижаться
leading up  —  ведушие ....
leading  —  ведущий
especially  —  особенно
fight  —  драться
soup  —  суп
hazelnut  —  фундук
back  —  спина
parsnips  —  пастернак
exhausting  —  утомительный
gist  —  суть
nuance  —  оттенок
passage  —  проход
jumpy  —  нервный
bother  —  беспокоиться
soul  —  душа
close  —  близко
too  —  тоже
literally  —  буквально
gesundheit  —  здоровье; будьте здоровы (при чиханье); ваше здоровье! (тост)
sound  —  крепкий
sapling  —  молодое деревце
charted  —  отмеченный на карте
adorable  —  очаровательный
mumbling  —  бормотание
hand  —  рука
so  —  таким образом
stinks  —  воняет
entire  —  целый
precious  —  драгоценный
pointless  —  бессмысленный
handle  —  справиться, управлять
closet  —  шкаф
satchel  —  ранец
boost  —  повышение
wuv  —  любовь по-детски
gotcha  —  попался
hint  —  намёк
healed  —  вылечили
afterwards  —  потом
guards  —  стража
passion  —  страсть
delinquent  —  правонарушитель
drop  —  бросать
fool  —  дурак
farther  —  дальше
bet  —  держать пари
cheesy  —  плохой
fundraiser  —  собирающий деньги
wrong  —  неправильный
language  —  язык
rhythmic  —  ритмичный
resident  —  а) постоянно проживающее лицо б) житель
foreign  —  иностранный
else  —  ещё
winning  —  победа
whatever  —  любой
tall  —  высокий
obsessed  —  одержимый
sickest  —  Больнее
rebel  —  бунтовщик
charm  —  очарование
messed  —  путаться
bonding  —  соединение
dope  —  наркотики
concerns  —  проблема
responsibility  —  ответственность
disturbances  —  потрясение
wave  —  махать
depicts  —  изображать на картине
stairs  —  ступеньки
hub  —  центр внимания
amazing  —  удивительный
onstage  —  на сцене
bored  —  скучающий
opposed  —  противоположный
stomach  —  желудок
holler  —  орать
crew  —  команда
opportunity  —  перспектива
groan  —  стонать
participate  —  участвовать
founded  —  основанный
withhold  —  отказывать
vital  —  жизненный
crap  —  дерьмо
weakest  —  слабейший
Freaked out.  —  волновался
choked  —  подавиться
nailed  —  приколоченный
amateurs  —  дилетант
bunch  —  связка
sweat  —  пот
brand  —  оставлять неизгладимое впечатление
shot  —  выстрел
break  —  ломать
head  —  голова
heading  —  курс
crash  —  крушение
Chill out.  —  расслабляться
defaced  —  обезображены
claimed  —  заявленный
notoriously  —  общеизвестно
elusive  —  неуловимый
rehearsal  —  репетиция
lagging  —  запаздывание
bouncing  —  отскакивать
heard  —  услышал
spread  —  распространять
obviously  —  очевидно
stat  —  без промедления
jammed  —  зажатый
eventually  —  в конце концов
compete  —  состязаться
neighborhood  —  соседство
jam  —  варенье
took  —  взял
 September 2012: 34
suspects  —  подозреваемый
roaring  —  ревущий
healthy  —  здоровый
cared about  —  заботился об(о)
cared  —  заботиться
pretending  —  притворяться
breath  —  дыхание
wasted  —  бесполезный
excitement  —  волнение
ill-disguised  —  плохо скрываемый
curiosity  —  любопытство
shocked  —  потрясен
seethed  —  закипел
whole  —  весь
summoned  —  вызванный
lying  —  лежащий
roused  —  пробуждать
screaming  —  орущий
riddles  —  загадка
maid  —  служанка
daybreak  —  рассвет
tale  —  рассказ
version  —  версия
anymore  —  больше не
embroidered  —  вышитый
picked over  —  получении более
scarce  —  редкий
gossip  —  сплетня
village  —  деревня
inhabitants  —  житель
horrible  —  страшный
half  —  половина
century  —  столетие
creepy  —  жуткий
 August 2012: 76
bounty  —  щедрость
beam  —  луч
stun  —  ошеломлять
hatch  —  вылупляться из яйца
hurts  —  больно
destiny  —  судьба
crude  —  сырой
bait  —  приманка
intrude  —  вторгаться
Hang on.  —  держаться
reckless  —  безрассудный
facility  —  возможности
You do have your moments  —  у вас есть лучшие моменты вашей жизни
judge  —  судить
rear  —  задняя сторона
cave  —  пещера
patience  —  терпение
asset  —  актив
offspring  —  потомство
thy  —  твой
scoundrel  —  подлец
trembling  —  дрожь
creeps  —  мурашки
Let go.  —  Отпусти.
glad  —  радостный
sighted  —  зрячий
How typical.  —  как типичный.
Why are you still here?  —  почему ты еще здесь?
wedge  —  клин
rogue  —  бродяга
tow  —  буксировать
troop  —  войска
launch  —  запускать
Hang on, kid.  —  держись, малыш.
admits  —  признавать
joint  —  совместный
joints  —  кабак
temper  —  характер
decoy  —  ловушка
the thought  —  мысли
You're familiar with.  —  вы знакомы с.
clouds  —  облака
scratch  —  скрести
face  —  лицо
go on  —  продолжать
pass on  —  передавать, оставлять (по наследству)
pass  —  передавать, проходить
strength  —  сила
rest  —  отдыхать
completed on schedule  —  завершены по графику
fleet  —  флот
grab  —  хватать
appreciate  —  оценивать
admit  —  допускать
pal  —  приятель
bear  —  терпеть
regret  —  сожалеть
smuggler  —  контрабандист
eyesight  —  зрение
scum  —  мерзавец
bids  —  ставки
sail  —  идти под парусами
bargain  —  сделка
knock  —  стук
sake  —  польза
apparent  —  очевидный
dispense  —  раздавать
proceed  —  действовать
confirmation  —  подтверждение
doom  —  рок
struggle  —  борьба
struggling  —  борющийся
spell  —  писать или произносить по буквам
vile  —  подлый
in an attempt to  —  в попытке ...
clutches  —  когти
 July 2012: 95
miss  —  скучать, пропустить, упустить
care for  —  любить, питать инетерес
sad  —  печальный
take off  —  взлетать
scrum  —  драться
stuck  —  застрять
greed  —  алчность
reward  —  вознаграждение
deal  —  сделка
head back  —  вернуться назад
shelter  —  приют, кров
immediately  —  немедленно
respect  —  уважение
settle  —  успокаиваться
chain  —  цепь
alarming  —  тревожный
deals  —  имеет дело
soothing  —  успокоительный
It's settled,  —  решено,
faith  —  вера
disturb  —  беспокоить
count on  —  рассчитывать на
arrogant  —  высокомерный
To speak with her about this matter.  —  говорить с ней об этом.
coupling  —  соединение
couplings  —  муфт
apprentice  —  подмастерье
rival  —  соперник
wit  —  остроумие
clever  —  умный
What took you so long?  —  Что вы так долго?
around  —  вокруг
intoxicating  —  опьяняющий
If there is an intruder.  —  если есть злоумышленника.
mistakes  —  ошибки
exercise  —  упражнение
In ten years, Master.  —  через десять лет, master.
Not at all.  —  вовсе нет, ничего
unbearable  —  невыносимый
hold off  —  удерживать, откладывать
duty  —  обязанность
I've failed you, Senator.  —  я подвел вас, сенатор.
I guess I was wrong.  —  я думаю, я был неправ.
overwhelmed  —  ошеломлённый
vote  —  голосовать
former  —  бывший
unrest  —  беспорядки
we'd be happy  —  мы были бы счастливы
perfectly  —  вполне
supreme  —  верховный
ambassadors  —  послы
at once  —  сразу
justice  —  правосудие
guardians  —  опекуны
dispatch  —  отправка
dispatched  —  отправлен
alarming chain of events  —  тревожно цепь событий
endlessly  —  бесконечно
matter  —  иметь значение
outlaying  —  ошиб. напис. outlying - отдаленный
routes  —  маршруты
aboard  —  на борту
warn  —  предупреждать
invasion  —  вторжение
encountered  —  неожиданно встретился
By now.  —  к этому времени
chancellor  —  канцлер
troops  —  войска
This turn of events is unfortunate.  —  такой поворот событий вызывает сожаление.
slime  —  слизь
stunted  —  низкорослый
dare  —  решиться
dispute  —  спор
fear  —  страх
distract  —  отвлекать
settlement  —  поселение
cowards  —  трусы
deal with  —  иметь дело с кем-л.
viceroy  —  вице-король
mindful  —  внимательный
belongs  —  принадлежать
anxieties  —  неприятности
yourselves  —  себя (сами)
this way, please  —  сюда пожалуйста
I'm TC-14 at your service.  —  у меня tc-14 к вашим услугам.
due  —  должный
With all due respect.  —  при всем уважении
board  —  доска
shipping  —  перевозка груза
greedy  —  жадный
taxation  —  обложение налогом
turmoil  —  смятение
engulfed  —  поглощен
mess  —  беспорядок
Just those with gifted minds.  —  только те, с одаренными умы.
 June 2012: 13
boarded  —  заколоченный (досками)
overlooking  —  с видом
hill  —  холм
stood  —  стоял
mine  —  мой
end up  —  в конечном итоге
coat  —  пальто
waist  —  талия
grow up  —  вырастать
certain  —  определённый
institutions  —  институты (общественные)
dealt  —  рассматриваются
villagers  —  сельский житель
 May 2012: 168
afoul  —  столкновения
trick  —  хитрость, трюк
odd  —  странный
slay  —  уничтожать
ought  —  должен
sneaking  —  сплетничать
blockage  —  запор
decline  —  спад
strangle  —  задушить
strange  —  странный
i get it  —  Я получаю это
staring  —  пялящийся
undies  —  разг. женское нижнее бельё
pull up  —  Поднимите
expenses  —  расходы
tuition  —  плата за обучение
gave up  —  отказались от
excessive  —  чрезмерный
slept  —  спал
jacket  —  куртка
separates  —  (no translation)
joke  —  шутка
dazzles  —  поражает
rehearse  —  репетировать
applicants  —  кандидаты
scholarship  —  стипендия
comprehensive  —  всесторонний
wrote  —  написал
whom  —  кого
phrase  —  фраза
stroke  —  инсульт
premed  —  слушатель подготовительных курсов при медицинском колледже
eye  —  глаз
touch  —  трогать
shout  —  Кричать
credited  —  пользующийся доверием
goat  —  козёл
slipping  —  скольжение
gifted  —  одарённый
frowned  —  нахмурился
lore  —  предания
heavily  —  тяжело
descent  —  происхождение
outskirts  —  окраина
hike  —  ходить пешком
filed  —  подавать
shipment  —  погрузка
approve  —  одобрять
hook  —  крючок
sinker  —  грузило
atrocity  —  жестокость
tie  —  галстук
taste  —  вкус
discreet  —  осторожный
astute  —  хитрый
douse  —  окунать
pitch  —  продвигать
behalf  —  от чего-то имени
responsible  —  ответственный
stocks  —  ценные бумаги
claiming  —  утверждать
injunction  —  запретительная норма
filing  —  хранение данных
upstairs  —  наверх
buzzing  —  жужжание
standby  —  готовность действовать
stay  —  оставаться
boot  —  ботинок
judgment  —  суждение
outcome  —  результат
discern  —  различать
beyond  —  по ту сторону
trump  —  козырь
garbage  —  отбросы
attach  —  прикреплять
wire  —  проволока
lift  —  поднимать
exposed  —  выставленный
abandon  —  отказываться
stunt  —  трюк
over-under  —  (no translation)
shutting  —  закрывая
quite  —  вполне
Earth  —  земля
captivity  —  плен
hunting  —  охота
long-lost  —  давно потерянный
ride  —  поездка
fork  —  вилка
least  —  по крайней мере
themselves  —  себя
loyal  —  преданный
apparently  —  вероятно
smelting  —  выплавка
cup  —  чашка
helmets  —  шлем
goggles  —  защитные очки
gear  —  передача (в машине)
defiance  —  вызов
reach  —  достигать
barbs  —  Колючка
caves  —  пещеры
Fire  —  пламя
forward  —  вперёд
towel  —  полотенце
sour  —  кислый
harangue  —  разглагольствовать
overpriced  —  завышенный по цене
incredibly  —  невероятно
spring  —  весна
wings  —  крылья
famous  —  известный, знаменитый
tide  —  течение
surf  —  прибой
scattered  —  раскиданный
breakthroughs  —  достижения
starvation  —  голодная смерть
kept  —  хранить, оставлять
profiteering  —  спекуляция
means  —  способ
cute  —  привлекательный
till  —  до тех пор пока
mentor  —  наставник
serving  —  обслуживание
prodigal  —  блудный
anointed  —  провозглашенный
cum  —  кончать
spotlight  —  всеобщее внимание
kidding  —  высмеивать, дразнить
ask  —  спрашивать
bone  —  кость
ogling  —  смотреть влюбленными глазами
appoint  —  назначать
irrevocably  —  безвозвратно
boring  —  скучный
disarray  —  беспорядок
rude  —  грубый
worthwhile  —  стоящий
viable  —  жизнеспособный
serve  —  помогать, быть полезным
counteract  —  нейтрализовать
gargle  —  полоскать
dismantle  —  демонтировать
count  —  считать
delight  —  восторг
adjourned  —  отсроченный
clowns  —  клоун
survived  —  выдержать
narrate  —  рассказывать
consider  —  рассматривать, принимать во внимание, учитывать
joiner  —  столяр
bless  —  благословлять
cower  —  съёживаться
insists  —  настаивать на
untold  —  бессчётный
attendance  —  посещаемость
apt  —  подходящий
ordered  —  заказал
wheel  —  колесо
mellow  —  сочный
alright  —  всё в порядке
tedious  —  утомительный
pool  —  спорт. бассейн
morons  —  идиот
steady  —  устойчивый
undisclosed  —  нераскрытый
despise  —  презирать
despite  —  несмотря на
 April 2012: 1
prompt  —  подсказка, быстрый, немедленный, проворный, вскоре
 March 2012: 163
rescue  —  спасать, спасение
harmless  —  безобидный, безвредный
achieves  —  достигает
vehicle  —  транспортное средство
incinerate  —  сжигать, испепелять
gently  —  нежно, мягко, спокойно
heat  —  жара, нагревать, отапливать
breakthrough  —  прорыв, достижение, открытие
stock  —  запас, акция, сырье, в продаже, иметь в налии
defend  —  защищать, оборонять, отстаивать
inch  —  дюйм
put  —  класть, ставить, положить
mouthful  —  глоток, полный рот (чего-либо), кусок, небольшое количество
intimidate  —  пугать, запугивать, устрашать
kicked  —  сбросить, пнуть, выбить
meal  —  пища
proves  —  доказывает
hereby  —  таким образом, настоящим, этим, юр. сим
threat  —  угроза, опасность
shield  —  щит, защищать, заслонять, защита, укрывать
chamber  —  комната, камера
fever  —  лихорадка, жар
ostentatious  —  показной, демонстративный, претенциозный
alloy  —  сплав
flaps  —  нечто широкое, плоское, свободно свешивающееся, болтающееся (мн.ч.)
buildup  —  накопление
worse  —  хуже, худший
discharge  —  освобождать, увольнять, разряжать, разгружать
trustworthy  —  заслуживающий доверия
irrelevant  —  неуместный, неуместный, неподходящий; не относящийся к делу, неподходящий
causing  —  вызывающий, заставляющий
contacting  —  связываться, общатся, быть на связи
foreseeable  —  обозримый, предсказуемый
snag  —  загвоздка, разг. препятствие
bump  —  толкать, подталкивать
indeed  —  действительно, в самом деле
petite  —  изящная, маленького роста, маленькая
circumstances  —  обстоятельства, условия, обстановка, среда
debrief  —  производить опрос послевыполнения задания
rid  —  освобождать, избавлять
tears  —  слезы
ahead  —  впереди, вперёд
missile  —  ракета, снаряд
wounds  —  рана, душевная обида, ранить
crown  —  корона, престол
humbly  —  смиренно, застенчиво
jewel  —  сокровище, ювелирное изделие, драгоценные камни, украшения
absorb  —  впитывать, поглощать, всасывать
funding  —  финансирование
rope  —  верёвка, канат
liaison  —  связь
ally  —  союзник, друг, сторонник
founder  —  основатель, учредитель
corroborated  —  подтверждать, подкреплять
allies  —  союзники
amend  —  вносить изменения
thrill  —  возбуждение, глубокое волнение
ticket  —  билет, квитанция, объявление
honored  —  честь, удостоенный, заслуженный
outside  —  снаружи
clothes  —  одежда, платье
prepared  —  подготовленный, готовый
defeat  —  поражение, наносить поражение, побеждать
stick  —  (at / to / with / by) держаться, придерживаться
award  —  награда, награждать
hurry  —  торопиться, торопить
honestly  —  честно, искренне
court-martial  —  трибунал, военный суд
ensuring  —  гарантировать, обеспечение, обеспечивать
ushers  —  швейцар
laude  —  хвалебное песнопение, лауда
stole  —  воровать, красть, красться
laugh  —  смеяться, смех, хохот
personal  —  личный, персональный
treasure  —  сокровище, высоко ценить
soon  —  скоро, вскоре
civilians  —  гражданское население
You too.  —  Тебя тоже.
approaching  —  приближение, подход
Remember, i got my eye on you.  —  (no translation)
awful  —  ужасно
throw  —  бросать, кидать
abode  —  жилище, местопребывание
damage  —  повреждать, убыток, портить, ущерб, дискредитировать
Are you alright?  —  ты в порядке?
prove  —  доказывать, пробовать, испытывать, подтверждать
retreat  —  отступление
toy  —  игрушка, забава
chest  —  грудь, грудная клетка, ящик
pretty 
хорошенький, достаточно, миловидный, разг. довольно, в значительной степени
decent  —  порядочный, приличный, подходящий
successor  —  наследник, преемник
mute  —  немой
Drop it.  —  (no translation)
yup  —  ага, угу, да
blow  —  дуть, веять
roof  —  крыша, кровля
Keep me posted.  —  держи меня в курсе
That's not going to be enough.  —  (no translation)
steer  —  направлять, руководить, намекать
fate  —  судьба, рок
worried  —  обеспокоенный
rare  —  редкий, необычный, необыкновенный
And i know in my heart that it's right.  —  (no translation)
You busy?  —  (no translation)
enemy  —  враг, враждебный
fruit  —  фрукт, плод
escape  —  избежать, спастись
refugees  —  беженцы
How about a little air?  —  (no translation)
smell  —  запах
Got it?  —  Понял?
hull  —  корпус
sluggish  —  вялый, медленный, пассивный
winding  —  извилистый
weapons  —  оружие
turn  —  поворот, очередь, превратить, отключить
waste  —  тратить впустую
A delivery date?  —  (no translation)
pinnacle  —  вершина
impressive  —  впечетляющий, выразительный
careful  —  заботливый, проявляющий заботу
He will set you free.  —  (no translation)
refuse  —  отказывать, отвергать
dice  —  играть в кости, кости
easy  —  лёгкий, нетрудный
joy  —  радость, восторг, счастье
gap  —  промежуток, разрыв, интервал
twins  —  двойники, двойня
weird  —  странный, непонятный
pull  —  тянуть, тащить
snuff  —  нюхательный табак или порошок
charge  —  заряжать, требовать плату, назначать
hate 
ненависть, ненавидеть, отвращение, чувствовать себя неловко, объект ненависти
still  —  до сих пор, по-прежнему, ещё
missed  —  упустить, потерпеть неудачу, ошибаться, скучать
earned  —  заработал, заслужили
kid  —  обманывать, надувать
warrior  —  воин
Me too.  —  (no translation)
Keep going.  —  Продолжайте!
fine  —  хороший, отличный, утончённо, изящно
spike  —  шип, острый выступ, гвоздь
dizzy  —  испытывающий / чувствующий головокружение
enjoy  —  наслаждаться, получать удовольствие
playpen  —  детский манеж
besides  —  кроме того, кроме
wrap  —  окутывать
plate  —  тарелка
pickle  —  соленье, маринад, пикули
lay  —  класть, положить, возлагать
straight  —  прямой, точно, правильно, метко, непроницаемое (лицо)
woods  —  деревья, роща, дрова
schlepp  —  амер, разг. 1) тащить, нести 2) тащиться | сущ, болван, тупица
goddamn  —  чертовский
remind  —  напоминать
treatment  —  лечение, уход
employee  —  служащий
accusing  —  обвинительный
Innocent  —  невинный, чистый, наивный
chair  —  стул
thief  —  вор
fair  —  честный, справедливый, ярмарка, светлый, красивый
 February 2012: 153
harder  —  труднее, сильнее
wimp  —  хлюпик, нытик, зануда
humped 
горбиться, горбить; сутулить; горбиться; приводить или приходить в дурное настроение; собрать все силы; приводить в дурное настроение; приходить в дурное настроение; портить настроение, сутулить, горбить
realize  —  осознавать, понимать, представлять себе
paid  —  оплаченный
frontier  —  граница, рубеж, фронт
guts  —  воля, характер, мужество
mean  —  значить, означать, иметь ввиду
treated  —  обращаться обходиться относиться
meant  —  хотел, означал, имел в виду
swear  —  клясться, браниться, выругаться
promise  —  обещание, обещать
luncheonette  —  закусочная, буфет
lean  —  скудный, опираться, тощий, прислоняться, наклон
meet 
встречаться, видеться, знакомться, соответствовать (требованиям), сталкиваться
grapes  —  виноград
wig  —  парик
leftover  —  остаток, пережиток
staff  —  персонал, сотрудники
right away  —  сразу, тотчас, немедленно
wallet  —  бумажник, сумка
stolen  —  украл
yet  —  ещё
picked  —  подобранный, выбрал, отобранный
leave  —  оставлять, покидать, уезжать
guess  —  догадываться, полагать, думать
ambulance  —  машина скорой помощи, скорая помощь
lead  —  вести, приводить, руководство, инициатива
spot 
какое-то определенное место, пятнышко, позор, тень, какое-то определенное место, пятнышко; крапинка; тень, позор, пятно (на чьей-л. репутации)
proud  —  гордый, высокомерный, самодовольный, надменный
scared  —  испуганный
tension  —  напряжение, неловкость, напряжённость, натянутость
shoulders  —  плечи
junk  —  разг. хлам, отбросы
trust  —  доверие, вера
lifts  —  поднимать, облегчать
getting  —  становится
wet  —  мокрый, влажный
bow  —  поклон, лук
Close your eyes.  —  (no translation)
heartbeat  —  пульсация сердца, биение
toe  —  палец на ноге
heel  —  пятка
wanna  —  хотеть, хотеть; разг. сокр. от want to
gig  —  концерт, концерт, живое выступление музыкальной группы
loan  —  заём, ссуда, давать взаймы, заимствование
fired  —  уволен
sick  —  больной
shit  —  дерьмо, вздор, чушь собачья
gotta  —  должен
hopeless  —  безнадёжный, отчаявшийся
salary  —  жалованье, заработная плата, оклад
right  —  право, правильный
away  —  прочь, вдаль
sweet  —  сладкий, милый
apology  —  извинение
blowing  —  дующий, дыхание, воздушный
doll  —  кукла
hardship  —  трудность, тяжёлое испытание
husbands  —  мужья, супруги
bungalow  —  бунгало, дом с верандой
terrific  —  потрясающий
waltz  —  вальс
envy  —  завидовать, зависть
enough  —  достаточно, довольно
roll  —  катить
guests  —  гости
hurt  —  делать больно, обижать, задевать
already  —  уже, ранее
starving  —  ужасно голодный
stuff  —  вещи, имущество, чепуха, фигня
daughters  —  дочери
hire  —  нанимать, прокат, предоставлять работу, приглашать на работу
gonna  —  собираться, (going to) идти
shake  —  трясти, встряхивать, сотрясать
robin  —  зоол. малиновка
stomp  —  топать
dead  —  мёртвый, умерший
mountain  —  гора
sacks  —  мешки, кульки
lawn  —  газон, лужайка
butt  —  задница, бочка, мишень, окурок, сигарета
sweetheart  —  дорогой, возлюбленный
annoy  —  раздражать
embarrass  —  смущать
doubtful  —  сомневающийся, полный сомнений, нерешительный
admiration  —  восхищение
crazy  —  ненормальный, псих
excited  —  взволнованный, взволнованный, возбуждённый (вследствие положительных эмоций)
gentle  —  спокойный, тихий
friendly  —  дружелюбный, дружески расположенный
cheerfulness  —  бодрость, жизнерадостность, общительность
fun  —  веселье
misfortunes  —  неудача, несчастье, злоключение, беда
affair  —  роман, дела, занятия
forgive  —  прощать
thought  —  думал (от think), мысль
mange  —  вет. чесотка
codfish  —  трескa
agreed  —  согласиться, договориться
frightened  —  испуганный
harm  —  вред, причинять вред, наносить ущерб, зло, ущерб
round  —  вокруг
bend  —  сгибать, изгиб, подчинять
perhaps  —  возможно, может быть
precisely  —  точно, определённо, строго
spend  —  тратить, проводить
distracted  —  отвлекать, сбивать с толку, смущать
silent  —  тихий, молчаливый, бесшумный, безмолвный
remain 
оставаться, оставаться, пребывать в прежнем состоянии или на прежнем месте
doubt 
сомнение, сомневаться, не доверять, нерешительность, испытывать сомнения
dresses  —  одежду
trousers  —  брюки, штаны
vision  —  видение, мечта
sudden  —  внезапный, неожиданный
envigorating  —  бодрящий
amuse  —  забавлять, развлекать, занимать внимание, развеселить, позабавить
contrary  —  вопреки, против
condolences  —  соболезнования
nevermind  —  все равно, забудь
rushed  —  торопиться, бросаться, кинуться, быстро побежать
laughed  —  рассмеяться
against  —  против
wake  —  просыпаться
caterpillar  —  гусеница
creatures  —  существо, создание, творение
hole  —  дыра, яма, отверствие
nightmare  —  ночной кошмар
willing  —  добровольный, готовый (сделать что-л), охотно делающий (что-либо)
ruin  —  разрушать, портить
venture 
отважиться, рискованное предприятие, решиться, осмелиться, рисковать (чем-л.)
gazebo  —  беседка
softball  —  софтбол
east  —  восток
diamond  —  алмаз, бриллиант, алмаз, бриллиант, бубны (масть в картах)
arcade  —  галерея
west  —  запад
guy  —  парень
occur  —  происходить, случаться, приходить на ум, встречаться
mind  —  память, разум, иметь мнение
bloom  —  цвести, расцветать, цветок, расти
family  —  семья
better  —  лучше, лучший, улучшать
learning  —  изучение, учение
mania  —  мания
good  —  хороший
Global  —  глобальный, мировой, всемирный
conversation  —  беседа
future  —  будущее
world  —  мир, свет
student  —  студент
t-shirt  —  футболка, тенниска
pay  —  платить, плата, выплата
practice  —  практика, практиковать
native  —  родной
11 level more 254 points  My progress
0%
Nostalgia

Going through old photographs Leo stopped on a picture of his grandfather. Yes, he was a brave lion, thought Leo. — He had so many battle wounds! Grandfather really was a bold fighter, got involved in fights with major enemies, with no fear of the consequences. However, the life of such animals does not last long, so grandfather Leo died early. It's best to have quick feet, than a brave heart, thought Leo to himself.
Reach level 15
Start!
Award
125 meatballs
Reach level 15
Corporate version For language schools For teachers and tutors For publishers or authors LinguaLeo in your country Affiliate program API for developers
© 2013 LinguaLeo FAQ Write to us!   
;)
х
Select all on page
